11111111111111111111111111111111111111111
1P0001000000000000000000C0000000000000001
1000010000011111110011111111100111110C001
1000000000010C00000000W0010C0000000000001
10000000000100000W00000001000001111110001
1000W111111100000000000000000000000000001
1000C000000000011111111W01111111111W00C01
1000000000000001000E000000000000000000001
11111111111111111111111111111111111111111