1111111111111111111111111111111111
1P0000000000000000000000C000000001
1000010000000000000000000000000001
1000011000011111111111111111100001
1000000000010C0000000000W000000001
1000000000010001111111111100000111
11111100000100000000000001000W0001
1000000000C10000000000000C00000001
1000011111110001111111111100000111
10000000000000010000000001000W0001
1000000000000001000C00000000000E01
1111111111111111111111111111111111