1111111111111111111111
1P000010000000C0000001
100000111001111000C001
1000000000010C00000001
1000W11111110000000001
10C0000000000001W00E01
1111111111111111111111